TST = "countries/Test.txt"
USA = "countries/United States of America.txt"
CAL = "countries/California.txt"
MST = "countries/Mojave Monsters.txt"
SPT = "countries/Septarsis.txt"
CAN = "countries/Canada.txt"
MEX = "countries/Mexico.txt"
OCE = "countries/Ocean.txt"
CLE = "countries/Cleaved Zone.txt"
MEW = "countries/Kingodm of Mewni.txt"
MAR = "countries/Marcos Mewni.txt"
JOH = "countries/Johansen Kingdom.txt"
PIG = "countries/Pigeon Kingdom.txt"
TRT = "countries/Tarantula Garrison.txt"
SPI = "countries/Spiderbite Kingdom.txt"
KGT = "countries/Mewman Knights.txt"
VSL = "countries/Vassal Revolt.txt"
MIN = "countries/Mina Revolt.txt"
MDM = "countries/Mewman Democracy.txt"
CUB = "countries/Cuba.txt"
BAH = "countries/Bahamas.txt"
DOM = "countries/Dominican Republic.txt"
HAI = "countries/Haiti.txt"
JAM = "countries/Jamaica.txt"
DEN = "countries/Denmark.txt"
RUS = "countries/Russia.txt"
MON = "countries/Traditionalist Mewni.txt"
MTR = "countries/Mosnter Neutral State.txt"

#Cleaved Nations
LAS = "countries/Las Vegas.txt"
NAV = "countries/Navajo Nation.txt"
FRG = "countries/Frog Federation.txt"
AVA = "countries/Avarius.txt"
PMK = "countries/Principal Monster Kingdom.txt"
STS = "countries/Stansbury.txt"
PTK = "countries/Principal Monster Kingdom.txt"
PNY = "countries/Ponyhead Ground Forces.txt"
CHL = "countries/Norcal Chaos.txt"
NCH = "countries/Nevada Chaos.txt"
NEV = "countries/Nevada.txt"
BAY = "countries/Bay Area.txt"
VAL = "countries/Southern Valley.txt"
ACH = "countries/Arachne Duchy.txt"
SOC = "countries/Socal.txt"
FLD = "countries/Featherleg Duchy.txt"
WRA = "countries/Wrathmelior Kingdom.txt"
